  2   0   1   0   0   0   0   0   0   0   4   0   0   0   0   0   0   0   0   0   0   0   0   0   0   0   0   5   0   0   0   0   0   0   0   0   0   1   0   2 
  2   0   1   12  0   1   0   0   0   0   5   0   0   0   0   0   0   1   0   12  0   1   0   0   0   0   0   4   0   0   0   0   0   1   0   12  1   1   0   2 
  2   0   3   0   1   0   1   0   0   0   0   0   0   0   0   0   1   0   1   0   1   0   1   0   0   0   0   0   0   0   0   0   1   0   1   0   0   1   0   2 
  2   0   1   1   0   12  0   1   0   0   0   0   0   0   0   1   0   12  0   1   0   12  0   1   0   0   0   0   0   0   0   1   0   12  0   1   1   1   0   2 
  2   0   1   1   1   0   1   0   1   0   0   0   0   0   1   0   1   0   1   0   1   0   1   0   1   0   0   0   0   0   1   0   1   0   1   0   1   1   0   2 
  2   0   1   1   0   1   0   12  0   1   0   0   0   1   0   12  0   1   1   1   1   1   0   12  0   1   0   0   0   1   0   12  0   1   0   0   1   1   0   2 
  2   0   3   1   0   0   1   0   1   0   1   0   1   0   1   0   1   0   1   3   1   0   1   0   1   0   1   0   1   0   1   0   1   0   0   0   1   1   0   2 
  2   0   1   1   1   1   1   1   0   12  0   1   0   12  0   1   0   1   1   1   1   1   1   1   0   12  0   1   0   12  0   1   1   1   8   1   1   1   0   2 
  2   0   1   0   0   0   0   0   0   0   1   0   1   0   0   0   0   0   0   0   0   0   0   0   0   0   1   0   1   0   0   0   0   0   0   0   0   1   0   2
  2   0   3   1   1   11  1   1   10  1   1   12  1   1   9   1   8   1   1   5   1   1   4   1   4   1   1   12  1   1   6   1   1   6   1   1   7   1   0   2 
  2   0   0   0   0   0   0   0   0   0   0   0   0   0   0   0   0   0   0   0   0   0   0   0   0   0   0   0   0   0   0   0   0   0   0   0   0   0   0   2 
  2   2   2   2   2   2   2   2   2   2   2   2   2   2   2   2   2   2   2   2   2   2   2   2   2   2   2   2   2   2   2   2   2   2   2   2   2   2   2   2 

