0   0  0  0  0  0  0  0  0  0  0  0  0  0  0  0  0  0  0  0  0  0  0  0  0  0  0  0  0  0  0  0  0  0  0  0  0  0  0  0
0   0  0  0  0  0  1  2  1  3  1  5  10 1  0  0  1  0  0 12 12  0  0  0  1  0  0  1  1  0  0  0  0  0  0  12 12  0  0  0
0   0  0  0  0  0  1  0  0  0  0  0  0  0  0  0  1  0  0 12 12  0  0  10 2  0  0  1  0  1  0  0  0  0  0  12 12  0  0  0
0   0  0  0  0  0  1  0  0  0  0  0  0  0  0  0  2  0  0  0  0  0  6  0  4  0  0  1  0  0  1  0  0  0  0  0  0  0  0  0
0   0  0  0  0  0  1  0  0  0  0  0  0  0  0  0  1  0  0  0  0  5  0  0  5  0  0  4  0  0  0  1  0  0  0  0  0  0  0  0
0   0  0  0  0  0  1  12 1  1  1  1  11 1  0  0  1  0  0  0  4  0  0  0  1  0  0  1  0  0  0  0  2  0  0  0  0  0  0  0
0   0  0  0  0  0  4  0  0  0  0  0  0  0  0  0  1  0  0  3  0  0  0  0  6  0  0  8  0  0  0  0  1  0  0  0  0  0  0  0
0   0  0  0  0  0  1  0  0  0  0  0  0  0  0  0  5  0  2  0  0  0  0  0  1  0  0  1  0  0  0  1  0  0  0  0  0  0  0  0
0   0  0  0  0  0  7  0  0  0  0  0  0  0  0  0  8  1  0  0  0  0  0  0  11 0  0  10 0  1  1  0  0  0  0  0  0  0  0  0
0   0  0  0  0  0  1  1  1  4  1  1  3  1  0  0  1  0  0  0  0  0  0  0  1  0  0  1  1  0  0  0  0  0  0  0  0  0  0  0
0   0  0  0  0  0  0  0  0  0  0  0  0  0  0  0  0  0  0  0  0  0  0  0  0  0  0  0  0  0  0  0  0  0  0  0  0  0  0  0
