   0   0   0   0   0   0   0   0   0   0   0   0   0   0   0   0   0   0   0   0   0   0   0   0   0   0   0   0   0   0   0   0   0   0   0   0   0   0   0   0 
   0   0   0   0   0   0   0   0   0   0   0   0   0   0   0   0   0   0   0   0   0   0   0   0   0   0   0   0   0   0   0   0   0   0   0   0   0   0   0   0 
   5   1   1   4   1   1   1   1   4   1   1   5   1   1   1   5   1   1   5   1   1   3   1   1   1   1   1   3   1   1   3   1   1   3   1   1   3   1   1   1 
   1   12  0   0   12  0   0   12  0   0   12  0   0   12  0   0   12  0   0   12  0   0   0   12  0   0   11  0   10  0   9   0   8   0   7   0   6   0   5   3 
   5   8   1   1   1   3   1   1   1   1   1   1   1   1   1   3   1   1   1   1   1   1   1   1   1   1   1   1   1   3   3   1   1   1   3   1   1   1   0   1 
   1   0   1   1   0   0   0   0   0   0   0   1   0   1   0   0   0   0   0   0   0   1   0   1   0   0   0   0   0   0   0   1   0   1   0   0   0   1   4   1 
   2   3   1   0   2   0   0   0   0   0   2   0   0   0   2   0   0   0   0   0   2   0   0   0   2   0   0   0   0   0   2   0   0   0   2   0   0   1   0   2 
   1   0   1   0   0   1   0   0   0   1   0   0   0   0   0   1   0   0   0   8   0   0   0   0   0   1   0   0   0   1   0   0   0   0   0   1   0   1   3   1 
   1   4   1   0   0   0   3   0   1   0   0   0   0   0   0   0   9   0   1   0   0   0   0   0   0   0   1   0   1   0   0   0   0   0   0   0   1   0   0   3 
   5   0   1   1   1   1   5   1   1   5   1   1   1   5   1   1   1   1   1   1   1   1   1   1   1   1   3   1   1   4   1   1   1   5   1   1   1   1   5   1 
   1   5   0   6   0   7   0   8   0   8   0   10  0   11  0   0   0   12  0   0   12  0   0   12  0   0   12  0   0   12  0   0   12  0   0   12  0   0   12  1
   1   1   1   1   3   1   1   1   3   1   1   1   1   3   1   1   1   3   1   1   1   1   1   1   3   1   1   3   1   1   1   1   1   1   1   1   1   1   1   1 


