0   0  0  0  0  0  0  0  0  0  0  0  0  0  0  0  0  0  0  0  0  0  0  0  0  0  0  0  0  0  0  0  0  0  0  0  0  0  0  0    
0   0  0  0  0  0  0  0  0  0  0  1  10  10  8  6  1  1  1  9  1  11  4  3  1  1  1  1  0  0  0  0  0  0  0  0  0  0  0    
0   0  0  0  0  0  0  0  0  0  2  0  0  0  0  0  0  0  12 0  0  0 12  0  0  0  0  0  0  1  0  0  0  0  0  0  0  0  0  0    
0   0  0  0  0  0  0  0  0  3  0  0  0  0  0  0  0  0  0  0  0  0  0  0  0  0 12  0  0  0  5  0  0  0  0  0  0  0  0  0    
0   0  0  0  0  0  0  0  4  0  0  1  1  1  0  1  1  1  0  1  10 1  0  1  1  1  0  1  1  1  0  1  0  0  0  0  0  0  0  0    
0   0  0  0  0  0  0  5  0  0  0  1  3  1  0  1  8  1  0  3  0  1  0  1  8  1  0  2  1  1  0  0  1  0  0  0  0  0  0  0    
0   0  0  0  0  0  0  2  0  0  0  1  1  1  0  1  1  1  0  4  1  1  0  1  1  1  0  1  1  1  0  0  2  0  0  0  0  0  0  0    
0   0  0  0  0  0  0  0  1  0  0 12  0  0  0  0  0  0  0  0  0  0  0  0  0  0  0  0  0  0  0  1  0  0  0  0  0  0  0  0    
0   0  0  0  0  0  0  0  0  5  0  0  0  0  0  0  0  0  0  0  0  0  0  0  0  0  0  0  0  0  1  0  0  0  0  0  0  0  0  0    
0   0  0  0  0  0  0  0  0  0  4  0  0  0  0  0  12 12 0  12 0 12  0  0 12  0  0  0  0  4  0  0  0  0  0  0  0  0  0  0    
0   0  0  0  0  0  0  0  0  0  0  1  1  2  1  1  1  1  6  3  4  6  7  9  11 8  6  3  1  0  0  0  0  0  0  0  0  0  0  0    
0   0  0  0  0  0  0  0  0  0  0  0  0  0  0  0  0  0  0  0  0  0  0  0  0  0  0  0  0  0  0  0  0  0  0  0  0  0  0  0    