0  0  0  0  0  0  0  0  0  0  0  0  0  0  0  0  0  0  0  0  0  0  0  0  0  0  0  0  0  0  0  0  0  0  0  0  0  0  0  0
0  0  0  0  0  0  0  0  0  0  0  0  0  0  0  0  0  0  0  0  0  0  0  0  0  0  0  0  0  0  0  0  0  0  0  0  0  0  0  0
0  0  0  0  0  0  0  10 0  0  0  0  0  0  0  0  0  4  0  0  0  0  0  0  0  0  1  0  0  0  0  0  0  0  0  1  0  0  0  0 
0  0  0  0  0  0  1  0  1  0  0  0  0  0  0  0  1  0  1  0  0  0  0  0  0  1  0  4  0  0  0  0  0  0  1  0  1  0  0  0  
0  0  0  0  0  8  0  0  0  5  0  0  0  0  0  2  0  0  0  6  0  0  0  0  8  0  0  0  1  0  0  0  0  1  0  0  0  8  0  0 
0  0  0  0  1  0  12 12 12 0  1  0  0  0  1  0  12 12 12 0  1  2  0  1  0  12 12 12 0  7  2  0  1  0  12 12 12 0  1  0 
0  0  0  5  0  0  12 3  12 0  0  1  6  1  0  0  12 3  12 0  0  1  1  0  0  12 3  12 0  0  1  1  0  0  12 3  12 0  0  1  
0  0  0  0  1  0  12 12 12 0  1  0  0  10 1  0  12 12 12 0  1  0  7  1  0  12 12 12 0  1  0  2  1  0  12 12 12 0  1  0  
0  0  0  0  0  2  0  0  0  9  0  0  0  0  0  1  0  0  0  1  0  0  0  0  10 0  0  0  11 0  0  0  0  1  0  0  0  1  0  0 
0  0  0  0  0  0  1  0  1  0  0  0  0  0  0  0  1  0  1  0  0  0  0  0  0  1  0  1  0  0  0  0  0  0  1  0  1  0  0  0 
0  0  0  0  0  0  0  1  0  0  0  0  0  0  0  0  0  1  0  0  0  0  0  0  0  0  1  0  0  0  0  0  0  0  0  8  0  0  0  0 
0  0  0  0  0  0  0  0  0  0  0  0  0  0  0  0  0  0  0  0  0  0  0  0  0  0  0  0  0  0  0  0  0  0  0  0  0  0  0  0